1111111111111111111111111111111111
1E1000001000000000000C000000000001
1010010100100001101001000000010101
1010010010101011001001000000010101
1P0000000C00C0010000000000000000C1
1111111111111111111111111111111111