11111111111
1000PEC1111
11111111111