11111111111111
10010000000C11
10100111110011
1P0011E0100011
11111111111111