11111111111111
10010000000C11
10100111110011
1P0011E010P011
11111111111111