11111111111
10C1PEC1111
11111111111